1
6
2 2 2 2 2 2
2 0 4 1 1 2
2 1 1 1 1 2
2 1 3 1 1 2
2 1 2 1 1 2
2 2 2 2 2 2