2
7
2 2 2 2 2 2 2
2 0 1 4 1 1 2
2 1 1 2 1 1 2
2 1 4 2 1 1 2
2 1 1 3 3 1 2
2 1 1 1 1 1 2
2 2 2 2 2 2 2