3
8
2 2 2 2 2 2 2 2
2 0 2 4 1 1 1 2
2 1 1 2 1 1 1 2
2 1 3 3 1 1 4 2
2 1 1 3 1 1 1 2
2 1 1 2 1 1 1 2
2 1 1 4 2 1 1 2
2 2 2 2 2 2 2 2